1 1 1 1 1 1 1 1 1 1 1 1 1 1 1 1
1 0 0 0 1 0 1 4 0 0 1 0 0 0 0 1
1 0 1 0 1 0 1 0 1 0 1 M 1 1 1 1
1 0 1 0 1 0 1 0 1 0 1 0 1 0 3 1
1 0 1 0 1 0 1 0 1 0 1 0 1 0 1 1
1 0 1 0 1 0 1 0 1 0 1 0 1 0 1 1
1 0 1 0 2 0 1 0 1 0 1 0 1 0 1 1
1 0 1 0 M 0 1 0 1 0 0 0 1 0 1 1
1 0 1 1 0 1 1 0 1 1 P 1 1 0 1 1
1 0 0 0 0 0 0 G 0 0 0 0 0 0 1 1
1 0 1 1 1 1 1 1 1 1 1 1 1 1 1 1
1 0 0 0 0 0 0 0 0 0 0 0 0 0 0 1
1 0 1 1 1 1 1 1 1 1 1 1 1 1 1 1
1 0 0 0 0 0 0 0 0 0 0 0 0 0 0 1
1 1 1 1 0 M 1 1 1 1 1 1 1 1 1 1
1 0 0 0 0 0 0 0 0 0 0 0 M 0 0 1
1 0 1 1 1 1 1 1 1 1 1 1 1 1 1 1
1 0 0 0 0 0 0 0 0 0 0 0 0 0 0 1
1 D 1 1 1 1 1 1 1 1 1 1 1 1 1 1