1 1 1 1 1 1 1 1 1 1
1 P 0 0 0 0 0 0 0 1
1 0 0 0 0 0 0 0 0 1
1 0 G 0 0 0 0 0 0 1
1 0 0 0 0 0 0 0 0 1
1 0 0 0 1 0 1 0 M 1
1 0 0 0 0 0 1 0 0 1 
1 0 0 0 1 0 0 0 0 1
1 M 0 0 2 3 4 0 M 1
1 D 1 1 1 1 1 1 1 1
